1
A(aa)
27
A(a) => B(a)
B(b) => C(b)
C(c) => D(c)
D(d) => E(d)
E(e) => F(e)
F(f) => G(f)
G(g) => H(g)
H(h) => I(h)
I(i) => J(i)
J(j) => K(j)
K(k) => L(k)
L(l) => M(l)
M(m) => N(m)
N(n) => O(n)
O(o) => P(o)
P(p) => Q(p)
Q(q) => R(q)
R(r) => S(r)
S(s) => T(s)
T(t) => U(t)
U(u) => V(u)
V(v) => W(v)
W(w) => X(w)
X(x) => Y(x)
Y(y) => Z(y)
Z(z) => A(z)
Z(az)